30 20 5 10
0 -100 10 -90 10 -90 20 0 15 -105 25 -55 25 -75 75 -85 
100 0 110 10 110 10 120 20 135 15 85 25 145 25 95 35 
-30 -110 0 -100 0 -60 10 -90 5 -95 15 -85 55 -105 25 -75 
90 -10 100 0 100 0 110 10 125 5 115 15 75 15 125 25 
-30 -110 -20 -60 0 -100 10 -90 -15 -95 35 -85 15 -85 25 -75 
90 -10 100 0 100 0 110 10 105 5 75 15 115 15 125 25 
-40 -120 -10 -110 -10 -110 0 -100 -5 -105 5 -95 5 -95 15 -85 
100 -20 90 -10 90 -10 100 0 95 -5 105 5 105 5 115 15 
-35 -155 -5 -85 -25 -105 25 -135 0 -100 10 -90 10 -90 20 -80 
85 -15 95 -5 95 -5 105 5 100 0 110 10 110 10 120 20 
-25 -125 -15 -115 5 -115 -5 -105 -10 -110 0 -100 0 -100 10 -90 
75 -25 85 -15 85 -15 95 -5 90 -10 100 0 100 0 110 10 
-25 -125 -15 -95 -15 -115 -5 -105 -10 -110 0 -100 0 -100 10 -90 
75 -25 85 -15 85 -15 95 -5 90 -10 100 0 100 0 110 10 
-35 -155 -25 -125 -25 -125 -15 -115 -20 -120 -10 -110 -10 -110 0 -100 
65 -35 75 -25 75 -25 85 -15 80 -20 90 -10 90 -10 100 0 
