50 30 5 5
0 -100 10 -90 10 -90 20 -80 35 -85 25 -75 45 -75 55 -65 
100 0 110 10 110 10 120 20 115 15 125 25 125 25 135 35 
-30 -110 0 -100 0 -80 10 -90 5 -95 15 -85 15 -85 25 -75 
110 -10 100 0 100 0 110 10 105 5 115 15 115 15 125 25 
-30 -110 0 -80 0 -100 10 -90 5 -95 35 -85 15 -85 25 -75 
110 -10 100 0 100 0 110 10 105 5 115 15 115 15 125 25 
-40 -120 -10 -110 -10 -110 0 -100 -5 -105 5 -95 5 -95 15 -85 
80 -20 90 -10 90 -10 100 0 95 -5 105 5 105 5 115 15 
-15 -115 -5 -105 -25 -105 5 -95 0 -100 10 -90 10 -90 20 -80 
85 -15 95 -5 95 -5 105 5 100 0 110 10 110 10 120 20 
-25 -125 -15 -115 -15 -115 -5 -105 -10 -110 0 -100 0 -100 10 -90 
75 -25 85 -15 85 -15 95 -5 90 -10 100 0 100 0 110 10 
-25 -125 -15 -115 -15 -115 -5 -105 -10 -110 0 -100 0 -100 10 -90 
75 -25 85 -15 85 -15 95 -5 90 -10 100 0 100 0 110 10 
-35 -135 -25 -125 -25 -125 -15 -115 -20 -120 -10 -110 -10 -110 0 -100 
65 -35 75 -25 75 -25 85 -15 80 -20 90 -10 90 -10 100 0 
