121 134 41 78
0 -68 42 -157 42 -157 38 43 52 -82 18 -86 18 -86 4 -61 
68 0 -118 0 -118 0 44 0 29 0 -119 0 -119 0 67 0 
-42 118 0 0 0 0 0 0 20 -20 0 0 44 28 0 0 
157 0 0 0 0 0 0 0 -63 0 0 0 -7 0 0 0 
-42 118 0 0 0 0 0 0 20 -20 44 28 0 0 0 0 
157 0 0 0 0 0 0 0 -63 0 -7 0 0 0 0 0 
-38 -44 0 0 0 0 0 0 -107 -35 0 0 0 0 0 0 
-43 0 0 0 0 0 0 0 -81 0 0 0 0 0 0 0 
-52 -29 -20 63 -20 63 107 81 0 0 0 0 0 0 0 0 
82 0 20 0 20 0 35 0 0 0 0 0 0 0 0 0 
-18 119 0 0 -44 7 0 0 0 0 0 0 0 0 0 0 
86 0 0 0 -28 0 0 0 0 0 0 0 0 0 0 0 
-18 119 -44 7 0 0 0 0 0 0 0 0 0 0 0 0 
86 0 -28 0 0 0 0 0 0 0 0 0 0 0 0 0 
-4 -67 0 0 0 0 0 0 0 0 0 0 0 0 0 0 
61 0 0 0 0 0 0 0 0 0 0 0 0 0 0 0 
0 0 0 0 0 0 0 0 0 0 0 0 0 0 0 0
0 0 0 0 0 0 0 0 0 0 0 0 0 0 0 0
0 0 0 0 0 0 0 0 0 0 0 0 0 0 0 0
0 0 0 0 0 0 0 0 0 0 0 0 0 0 0 0
0 0 0 0 0 0 0 0 0 0 0 0 0 0 0 0
0 0 0 0 0 0 0 0 0 0 0 0 0 0 0 0
0 0 0 0 0 0 0 0 0 0 0 0 0 0 0 0
0 0 0 0 0 0 0 0 0 0 0 0 0 0 0 0
0 0 0 0 0 0 0 0 0 0 0 0 0 0 0 0
0 0 0 0 0 0 0 0 0 0 0 0 0 0 0 0
0 0 0 0 0 0 0 0 0 0 0 0 0 0 0 0
0 0 0 0 0 0 0 0 0 0 0 0 0 0 0 0
0 0 0 0 0 0 0 0 0 0 0 0 0 0 0 0
0 0 0 0 0 0 0 0 0 0 0 0 0 0 0 0
0 0 0 0 0 0 0 0 0 0 0 0 0 0 0 0
0 0 0 0 0 0 0 0 0 0 0 0 0 0 0 0
