60 100 19 24
0 -85 25 -71 25 -71 31 -13 154 -90 79 -117 79 -117 -23 -14 
85 0 -77 0 -77 0 -54 0 -91 0 -7 0 -7 0 60 0 
-25 77 0 0 0 0 0 0 30 48 0 0 -70 56 0 0 
71 0 0 0 0 0 0 0 -33 0 0 0 10 0 0 0 
-25 77 0 0 0 0 0 0 30 48 -70 56 0 0 0 0 
71 0 0 0 0 0 0 0 -33 0 10 0 0 0 0 0 
-31 54 0 0 0 0 0 0 -120 -92 0 0 0 0 0 0 
13 0 0 0 0 0 0 0 -68 0 0 0 0 0 0 0 
-154 91 -30 33 -30 33 120 68 0 0 0 0 0 0 0 0 
90 0 -48 0 -48 0 92 0 0 0 0 0 0 0 0 0 
-79 7 0 0 70 -10 0 0 0 0 0 0 0 0 0 0 
117 0 0 0 -56 0 0 0 0 0 0 0 0 0 0 0 
-79 7 70 -10 0 0 0 0 0 0 0 0 0 0 0 0 
117 0 -56 0 0 0 0 0 0 0 0 0 0 0 0 0 
23 -60 0 0 0 0 0 0 0 0 0 0 0 0 0 0 
14 0 0 0 0 0 0 0 0 0 0 0 0 0 0 0 

