13 -8 4 -4
0 57 23 26 23 26 24 -75 38 -34 -20 -29 -20 -29 29 -54 
-57 0 -35 0 -35 0 19 0 10 0 -57 0 -57 0 -5 0 
-23 35 0 0 0 0 0 0 -6 -73 0 0 27 -28 0 0 
-26 0 0 0 0 0 0 0 -19 0 0 0 11 0 0 0 
-23 35 0 0 0 0 0 0 -6 -73 27 -28 0 0 0 0 
-26 0 0 0 0 0 0 0 -19 0 11 0 0 0 0 0 
-24 -19 0 0 0 0 0 0 62 33 0 0 0 0 0 0 
75 0 0 0 0 0 0 0 -53 0 0 0 0 0 0 0 
-38 -10 6 19 6 19 -62 53 0 0 0 0 0 0 0 0 
34 0 73 0 73 0 -33 0 0 0 0 0 0 0 0 0 
20 57 0 0 -27 -11 0 0 0 0 0 0 0 0 0 0 
29 0 0 0 28 0 0 0 0 0 0 0 0 0 0 0 
20 57 -27 -11 0 0 0 0 0 0 0 0 0 0 0 0 
29 0 28 0 0 0 0 0 0 0 0 0 0 0 0 0 
-29 5 0 0 0 0 0 0 0 0 0 0 0 0 0 0 
54 0 0 0 0 0 0 0 0 0 0 0 0 0 0 0 
0 0 0 0 0 0 0 0 0 0 0 0 0 0 0 0
0 0 0 0 0 0 0 0 0 0 0 0 0 0 0 0
0 0 0 0 0 0 0 0 0 0 0 0 0 0 0 0
0 0 0 0 0 0 0 0 0 0 0 0 0 0 0 0
0 0 0 0 0 0 0 0 0 0 0 0 0 0 0 0
0 0 0 0 0 0 0 0 0 0 0 0 0 0 0 0
0 0 0 0 0 0 0 0 0 0 0 0 0 0 0 0
0 0 0 0 0 0 0 0 0 0 0 0 0 0 0 0
0 0 0 0 0 0 0 0 0 0 0 0 0 0 0 0
0 0 0 0 0 0 0 0 0 0 0 0 0 0 0 0
0 0 0 0 0 0 0 0 0 0 0 0 0 0 0 0
0 0 0 0 0 0 0 0 0 0 0 0 0 0 0 0
0 0 0 0 0 0 0 0 0 0 0 0 0 0 0 0
0 0 0 0 0 0 0 0 0 0 0 0 0 0 0 0
0 0 0 0 0 0 0 0 0 0 0 0 0 0 0 0
0 0 0 0 0 0 0 0 0 0 0 0 0 0 0 0
