120 93 183 417
0 101 24 -209 24 -209 65 -95 -119 -360 -63 -120 -63 -120 -27 8 
-101 0 -182 0 -182 0 -39 0 -15 0 -57 0 -57 0 -39 0 
-24 182 0 0 0 0 0 0 26 -370 0 0 98 -140 0 0 
209 0 0 0 0 0 0 0 24 0 0 0 -146 0 0 0 
0 0 0 0 0 0 0 0 0 0 0 0 0 0 0 0 
0 0 0 0 0 0 0 0 0 0 0 0 0 0 0 0 
0 0 0 0 0 0 0 0 0 0 0 0 0 0 0 0 
0 0 0 0 0 0 0 0 0 0 0 0 0 0 0 0 
0 0 0 0 0 0 0 0 0 0 0 0 0 0 0 0 
0 0 0 0 0 0 0 0 0 0 0 0 0 0 0 0 
0 0 0 0 0 0 0 0 0 0 0 0 0 0 0 0 
0 0 0 0 0 0 0 0 0 0 0 0 0 0 0 0 
0 0 0 0 0 0 0 0 0 0 0 0 0 0 0 0 
0 0 0 0 0 0 0 0 0 0 0 0 0 0 0 0 
0 0 0 0 0 0 0 0 0 0 0 0 0 0 0 0 
0 0 0 0 0 0 0 0 0 0 0 0 0 0 0 0 
0 50 16 -36 10 -64 11 76 -2 13 8 75 16 56 -69 38 
-70 0 -16 0 2 0 -56 0 -38 0 48 0 38 0 -5 0 
-28 7 0 0 -55 -28 0 0 -20 11 0 0 46 -33 0 0 
-24 0 0 0 54 0 0 0 21 0 0 0 -12 0 0 0 
73 -79 77 -35 0 0 0 0 42 -43 -9 -3 0 0 0 0 
66 0 32 0 0 0 0 0 62 0 -47 0 0 0 0 0 
-4 0 0 0 0 0 0 0 -7 1 0 0 0 0 0 0 
-58 0 0 0 0 0 0 0 6 0 0 0 0 0 0 0 
41 26 33 53 -3 -48 37 56 0 0 0 0 0 0 0 0 
28 0 23 0 -14 0 0 0 0 0 0 0 0 0 0 0 
39 -61 0 0 65 87 0 0 0 0 0 0 0 0 0 0 
-72 0 0 0 18 0 0 0 0 0 0 0 0 0 0 0 
-17 -16 46 -68 0 0 0 0 0 0 0 0 0 0 0 0 
69 0 2 0 0 0 0 0 0 0 0 0 0 0 0 0 
30 76 0 0 0 0 0 0 0 0 0 0 0 0 0 0 
4 0 0 0 0 0 0 0 0 0 0 0 0 0 0 0 

