55 68 4 91
0 -97 9 0 9 0 79 14 67 61 -122 27 -122 27 -110 -10 
97 0 20 0 20 0 43 0 -102 0 -124 0 -124 0 60 0 
-9 -20 0 0 0 0 0 0 -132 -83 0 0 -60 -55 0 0 
0 0 0 0 0 0 0 0 -9 0 0 0 -79 0 0 0 
-9 -20 0 0 0 0 0 0 -132 -83 -60 -55 0 0 0 0 
0 0 0 0 0 0 0 0 -9 0 -79 0 0 0 0 0 
-79 -43 0 0 0 0 0 0 -101 -94 0 0 0 0 0 0 
-14 0 0 0 0 0 0 0 -26 0 0 0 0 0 0 0 
-67 102 132 9 132 9 101 26 0 0 0 0 0 0 0 0 
-61 0 83 0 83 0 94 0 0 0 0 0 0 0 0 0 
122 124 0 0 60 79 0 0 0 0 0 0 0 0 0 0 
-27 0 0 0 55 0 0 0 0 0 0 0 0 0 0 0 
122 124 60 79 0 0 0 0 0 0 0 0 0 0 0 0 
-27 0 55 0 0 0 0 0 0 0 0 0 0 0 0 0 
110 -60 0 0 0 0 0 0 0 0 0 0 0 0 0 0 
10 0 0 0 0 0 0 0 0 0 0 0 0 0 0 0 

