56 107 5 0
0 -120 12 -111 12 -111 61 -19 123 -126 83 -84 83 -84 -31 -18 
120 0 -103 0 -103 0 -85 0 -77 0 -11 0 -11 0 64 0 
-12 103 0 0 0 0 0 0 18 75 0 0 -97 32 0 0 
111 0 0 0 0 0 0 0 1 0 0 0 32 0 0 0 
-12 103 0 0 0 0 0 0 18 75 -97 32 0 0 0 0 
111 0 0 0 0 0 0 0 1 0 32 0 0 0 0 0 
-61 85 0 0 0 0 0 0 -139 -107 0 0 0 0 0 0 
19 0 0 0 0 0 0 0 -67 0 0 0 0 0 0 0 
-123 77 -18 -1 -18 -1 139 67 0 0 0 0 0 0 0 0 
126 0 -75 0 -75 0 107 0 0 0 0 0 0 0 0 0 
-83 11 0 0 97 -32 0 0 0 0 0 0 0 0 0 0 
84 0 0 0 -32 0 0 0 0 0 0 0 0 0 0 0 
-83 11 97 -32 0 0 0 0 0 0 0 0 0 0 0 0 
84 0 -32 0 0 0 0 0 0 0 0 0 0 0 0 0 
31 -64 0 0 0 0 0 0 0 0 0 0 0 0 0 0 
18 0 0 0 0 0 0 0 0 0 0 0 0 0 0 0 
0 0 0 0 0 0 0 0 0 0 0 0 0 0 0 0
0 0 0 0 0 0 0 0 0 0 0 0 0 0 0 0
0 0 0 0 0 0 0 0 0 0 0 0 0 0 0 0
0 0 0 0 0 0 0 0 0 0 0 0 0 0 0 0
0 0 0 0 0 0 0 0 0 0 0 0 0 0 0 0
0 0 0 0 0 0 0 0 0 0 0 0 0 0 0 0
0 0 0 0 0 0 0 0 0 0 0 0 0 0 0 0
0 0 0 0 0 0 0 0 0 0 0 0 0 0 0 0
0 0 0 0 0 0 0 0 0 0 0 0 0 0 0 0
0 0 0 0 0 0 0 0 0 0 0 0 0 0 0 0
0 0 0 0 0 0 0 0 0 0 0 0 0 0 0 0
0 0 0 0 0 0 0 0 0 0 0 0 0 0 0 0
0 0 0 0 0 0 0 0 0 0 0 0 0 0 0 0
0 0 0 0 0 0 0 0 0 0 0 0 0 0 0 0
0 0 0 0 0 0 0 0 0 0 0 0 0 0 0 0
0 0 0 0 0 0 0 0 0 0 0 0 0 0 0 0
