111 116 207 390
0 11 4 -185 4 -185 66 -137 -112 -294 -55 -98 -55 -98 -33 -74 
-11 0 -158 0 -158 0 -43 0 2 0 12 0 12 0 -30 0 
-4 158 0 0 0 0 0 0 29 -303 0 0 38 -91 0 0 
185 0 0 0 0 0 0 0 -44 0 0 0 -220 0 0 0 
-4 158 0 0 0 0 0 0 29 -303 38 -91 0 0 0 0 
185 0 0 0 0 0 0 0 -44 0 -220 0 0 0 0 0 
-66 43 0 0 0 0 0 0 29 -203 0 0 0 0 0 0 
137 0 0 0 0 0 0 0 -184 0 0 0 0 0 0 0 
112 -2 -29 44 -29 44 -29 184 0 0 0 0 0 0 0 0 
294 0 303 0 303 0 203 0 0 0 0 0 0 0 0 0 
55 -12 0 0 -38 220 0 0 0 0 0 0 0 0 0 0 
98 0 0 0 91 0 0 0 0 0 0 0 0 0 0 0 
55 -12 -38 220 0 0 0 0 0 0 0 0 0 0 0 0 
98 0 91 0 0 0 0 0 0 0 0 0 0 0 0 0 
33 30 0 0 0 0 0 0 0 0 0 0 0 0 0 0 
74 0 0 0 0 0 0 0 0 0 0 0 0 0 0 0 

