45 103 3 96
0 -61 7 11 7 11 96 56 87 107 -170 49 -170 49 -140 -21 
61 0 69 0 69 0 3 0 -132 0 -114 0 -114 0 99 0 
-7 -69 0 0 0 0 0 0 -84 -70 0 0 -11 -44 0 0 
-11 0 0 0 0 0 0 0 -19 0 0 0 -90 0 0 0 
-7 -69 0 0 0 0 0 0 -84 -70 -11 -44 0 0 0 0 
-11 0 0 0 0 0 0 0 -19 0 -90 0 0 0 0 0 
-96 -3 0 0 0 0 0 0 -119 -44 0 0 0 0 0 0 
-56 0 0 0 0 0 0 0 -52 0 0 0 0 0 0 0 
-87 132 84 19 84 19 119 52 0 0 0 0 0 0 0 0 
-107 0 70 0 70 0 44 0 0 0 0 0 0 0 0 0 
170 114 0 0 11 90 0 0 0 0 0 0 0 0 0 0 
-49 0 0 0 44 0 0 0 0 0 0 0 0 0 0 0 
170 114 11 90 0 0 0 0 0 0 0 0 0 0 0 0 
-49 0 44 0 0 0 0 0 0 0 0 0 0 0 0 0 
140 -99 0 0 0 0 0 0 0 0 0 0 0 0 0 0 
21 0 0 0 0 0 0 0 0 0 0 0 0 0 0 0 

