149 128 23 32
0 27 42 -64 42 -64 75 72 83 -30 112 -50 112 -50 -109 77 
-27 0 58 0 58 0 10 0 -103 0 -100 0 -100 0 19 0 
-42 -58 0 0 0 0 0 0 14 -53 0 0 -62 76 0 0 
64 0 0 0 0 0 0 0 57 0 0 0 -71 0 0 0 
-42 -58 0 0 0 0 0 0 14 -53 -62 76 0 0 0 0 
64 0 0 0 0 0 0 0 57 0 -71 0 0 0 0 0 
-75 -10 0 0 0 0 0 0 -44 18 0 0 0 0 0 0 
-72 0 0 0 0 0 0 0 -109 0 0 0 0 0 0 0 
-83 103 -14 -57 -14 -57 44 109 0 0 0 0 0 0 0 0 
30 0 53 0 53 0 -18 0 0 0 0 0 0 0 0 0 
-112 100 0 0 62 71 0 0 0 0 0 0 0 0 0 0 
50 0 0 0 -76 0 0 0 0 0 0 0 0 0 0 0 
-112 100 62 71 0 0 0 0 0 0 0 0 0 0 0 0 
50 0 -76 0 0 0 0 0 0 0 0 0 0 0 0 0 
109 -19 0 0 0 0 0 0 0 0 0 0 0 0 0 0 
-77 0 0 0 0 0 0 0 0 0 0 0 0 0 0 0 

