30 20 5 15
0 -100 10 -130 10 -90 20 -120 15 -105 25 -75 25 -75 135 -85 
100 0 110 10 110 10 120 20 75 15 105 25 105 25 95 35 
-10 -110 0 -100 0 -60 10 -90 5 -15 15 -85 35 -125 25 -75 
90 -10 100 0 100 0 110 10 105 5 115 15 75 15 125 25 
-10 -110 0 0 0 -100 10 -90 5 -35 115 -125 15 -85 25 -75 
90 -10 100 0 100 0 110 10 145 5 75 15 115 15 125 25 
-40 -120 -10 -110 -10 -110 0 -100 -5 -105 5 -95 5 -95 15 -85 
120 -20 90 -10 90 -10 100 0 95 -5 105 5 105 5 115 15 
-15 -95 -5 -105 -5 -105 45 -75 0 -100 10 -90 10 -90 20 -80 
85 -15 95 -5 95 -5 125 5 100 0 110 10 110 10 120 20 
-25 -125 -15 -115 5 -115 -5 -105 -10 -110 0 -100 0 -100 10 -90 
75 -25 85 -15 85 -15 95 -5 90 -10 100 0 100 0 110 10 
-25 -145 -15 -115 -15 -115 -5 -105 -10 -110 0 -100 0 -100 10 -90 
75 -25 85 -15 85 -15 95 -5 90 -10 100 0 100 0 110 10 
-35 -15 -25 -125 -25 -125 -15 -115 -20 -120 -10 -110 -10 -110 0 -100 
85 -35 75 -25 75 -25 85 -15 80 -20 90 -10 90 -10 100 0 
