50 30 5 5
-20 -100 10 -130 10 -90 20 -80 15 -105 45 -75 45 -75 75 -105 
100 0 110 10 110 10 120 20 75 15 85 25 145 25 95 35 
-30 -110 0 -100 -20 -80 10 -90 5 -135 15 -85 55 -85 25 -75 
110 -10 100 0 100 0 110 10 105 5 115 15 75 15 125 25 
-30 -110 -20 -60 0 -100 10 -90 5 -115 55 -85 15 -85 25 -75 
110 -10 100 0 100 0 110 10 145 5 75 15 115 15 125 25 
-40 -120 -10 -110 -10 -110 0 -100 -5 -105 5 -95 5 -95 15 -85 
120 -20 90 -10 90 -10 100 0 95 -5 105 5 105 5 115 15 
-115 -95 -25 -105 -5 -105 5 -95 0 -100 10 -90 10 -90 20 -80 
85 -15 95 -5 95 -5 105 5 100 0 110 10 110 10 120 20 
-45 -125 -15 -115 -15 -115 -5 -105 -10 -110 0 -100 0 -100 10 -90 
75 -25 85 -15 85 -15 95 -5 90 -10 100 0 100 0 110 10 
-45 -125 -15 -115 -15 -115 -5 -105 -10 -110 0 -100 0 -100 10 -90 
75 -25 105 -15 85 -15 95 -5 90 -10 100 0 100 0 110 10 
-35 -195 -25 -125 -25 -125 -15 -115 -20 -120 -10 -110 -10 -110 0 -100 
65 -35 75 -25 75 -25 85 -15 80 -20 90 -10 90 -10 100 0 
