103 124 70 121
0 -100 4 -109 4 -109 53 12 82 -77 13 -112 13 -112 -12 -63 
100 0 -103 0 -103 0 19 0 37 0 -107 0 -107 0 18 0 
-4 103 0 0 0 0 0 0 33 19 0 0 61 49 0 0 
109 0 0 0 0 0 0 0 -83 0 0 0 14 0 0 0 
-4 103 0 0 0 0 0 0 33 19 61 49 0 0 0 0 
109 0 0 0 0 0 0 0 -83 0 14 0 0 0 0 0 
-53 -19 0 0 0 0 0 0 -75 -41 0 0 0 0 0 0 
-12 0 0 0 0 0 0 0 -114 0 0 0 0 0 0 0 
-82 -37 -33 83 -33 83 75 114 0 0 0 0 0 0 0 0 
77 0 -19 0 -19 0 41 0 0 0 0 0 0 0 0 0 
-13 107 0 0 -61 -14 0 0 0 0 0 0 0 0 0 0 
112 0 0 0 -49 0 0 0 0 0 0 0 0 0 0 0 
-13 107 -61 -14 0 0 0 0 0 0 0 0 0 0 0 0 
112 0 -49 0 0 0 0 0 0 0 0 0 0 0 0 0 
12 -18 0 0 0 0 0 0 0 0 0 0 0 0 0 0 
63 0 0 0 0 0 0 0 0 0 0 0 0 0 0 0 

