-5 53 20 187
0 30 22 -117 22 -117 71 9 79 76 179 -17 179 -17 -144 123 
-30 0 29 0 29 0 -176 0 61 0 -154 0 -154 0 -15 0 
-22 -29 0 0 0 0 0 0 95 -103 0 0 -147 37 0 0 
117 0 0 0 0 0 0 0 12 0 0 0 -80 0 0 0 
-22 -29 0 0 0 0 0 0 95 -103 -147 37 0 0 0 0 
117 0 0 0 0 0 0 0 12 0 -80 0 0 0 0 0 
-71 176 0 0 0 0 0 0 -144 76 0 0 0 0 0 0 
-9 0 0 0 0 0 0 0 15 0 0 0 0 0 0 0 
-79 -61 -95 -12 -95 -12 144 -15 0 0 0 0 0 0 0 0 
-76 0 103 0 103 0 -76 0 0 0 0 0 0 0 0 0 
-179 154 0 0 147 80 0 0 0 0 0 0 0 0 0 0 
17 0 0 0 -37 0 0 0 0 0 0 0 0 0 0 0 
-179 154 147 80 0 0 0 0 0 0 0 0 0 0 0 0 
17 0 -37 0 0 0 0 0 0 0 0 0 0 0 0 0 
144 15 0 0 0 0 0 0 0 0 0 0 0 0 0 0 
-123 0 0 0 0 0 0 0 0 0 0 0 0 0 0 0 

