145 196 9 8
0 -8 29 -104 29 -104 105 66 52 -66 116 -17 116 -17 -117 73 
8 0 32 0 32 0 -21 0 -89 0 -104 0 -104 0 23 0 
-29 -32 0 0 0 0 0 0 2 -26 0 0 -89 52 0 0 
104 0 0 0 0 0 0 0 91 0 0 0 -49 0 0 0 
-29 -32 0 0 0 0 0 0 2 -26 -89 52 0 0 0 0 
104 0 0 0 0 0 0 0 91 0 -49 0 0 0 0 0 
-105 21 0 0 0 0 0 0 -63 3 0 0 0 0 0 0 
-66 0 0 0 0 0 0 0 -108 0 0 0 0 0 0 0 
-52 89 -2 -91 -2 -91 63 108 0 0 0 0 0 0 0 0 
66 0 26 0 26 0 -3 0 0 0 0 0 0 0 0 0 
-116 104 0 0 89 49 0 0 0 0 0 0 0 0 0 0 
17 0 0 0 -52 0 0 0 0 0 0 0 0 0 0 0 
-116 104 89 49 0 0 0 0 0 0 0 0 0 0 0 0 
17 0 -52 0 0 0 0 0 0 0 0 0 0 0 0 0 
117 -23 0 0 0 0 0 0 0 0 0 0 0 0 0 0 
-73 0 0 0 0 0 0 0 0 0 0 0 0 0 0 0 
0 0 0 0 0 0 0 0 0 0 0 0 0 0 0 0
0 0 0 0 0 0 0 0 0 0 0 0 0 0 0 0
0 0 0 0 0 0 0 0 0 0 0 0 0 0 0 0
0 0 0 0 0 0 0 0 0 0 0 0 0 0 0 0
0 0 0 0 0 0 0 0 0 0 0 0 0 0 0 0
0 0 0 0 0 0 0 0 0 0 0 0 0 0 0 0
0 0 0 0 0 0 0 0 0 0 0 0 0 0 0 0
0 0 0 0 0 0 0 0 0 0 0 0 0 0 0 0
0 0 0 0 0 0 0 0 0 0 0 0 0 0 0 0
0 0 0 0 0 0 0 0 0 0 0 0 0 0 0 0
0 0 0 0 0 0 0 0 0 0 0 0 0 0 0 0
0 0 0 0 0 0 0 0 0 0 0 0 0 0 0 0
0 0 0 0 0 0 0 0 0 0 0 0 0 0 0 0
0 0 0 0 0 0 0 0 0 0 0 0 0 0 0 0
0 0 0 0 0 0 0 0 0 0 0 0 0 0 0 0
0 0 0 0 0 0 0 0 0 0 0 0 0 0 0 0
