30 50 5 10
-20 -100 -10 -90 10 -50 20 -80 15 -5 25 -15 45 -75 75 -85 
100 0 110 10 110 10 120 20 115 15 125 25 125 25 95 35 
-30 -110 0 -100 -20 -40 10 -90 5 -95 15 -85 15 -85 25 -75 
110 -10 100 0 100 0 110 10 145 5 115 15 115 15 125 25 
-30 -110 0 -80 0 -100 10 -90 5 -95 35 -85 15 -85 25 -75 
110 -10 80 0 100 0 110 10 125 5 55 15 115 15 125 25 
-60 -120 -10 -110 -10 -110 0 -100 -5 -105 5 -95 5 -95 15 -85 
80 -20 90 -10 90 -10 100 0 95 -5 105 5 105 5 115 15 
-15 -115 -5 -105 15 -105 5 -95 0 -100 10 -90 10 -90 20 -80 
105 -15 95 -5 75 -5 105 5 100 0 110 10 110 10 120 20 
-25 -125 -15 -115 -15 -115 -5 -105 -10 -110 0 -100 0 -100 10 -90 
75 -25 85 -15 85 -15 95 -5 90 -10 100 0 100 0 110 10 
-25 -125 -15 -115 -15 -115 -5 -105 -10 -110 0 -100 0 -100 10 -90 
75 -25 85 -15 85 -15 95 -5 90 -10 100 0 100 0 110 10 
-35 -135 -25 -125 -25 -125 -15 -115 -20 -120 -10 -110 -10 -110 0 -100 
65 -35 75 -25 75 -25 85 -15 80 -20 90 -10 90 -10 100 0 
