-48 -55 70 188
0 17 56 -45 56 -45 -6 14 79 1 154 -23 154 -23 -90 130 
-17 0 102 0 102 0 -54 0 152 0 -131 0 -131 0 5 0 
-56 -102 0 0 0 0 0 0 41 -140 0 0 -166 39 0 0 
45 0 0 0 0 0 0 0 -18 0 0 0 -72 0 0 0 
-56 -102 0 0 0 0 0 0 41 -140 -166 39 0 0 0 0 
45 0 0 0 0 0 0 0 -18 0 -72 0 0 0 0 0 
6 54 0 0 0 0 0 0 -26 44 0 0 0 0 0 0 
-14 0 0 0 0 0 0 0 -1 0 0 0 0 0 0 0 
-79 -152 -41 18 -41 18 26 1 0 0 0 0 0 0 0 0 
-1 0 140 0 140 0 -44 0 0 0 0 0 0 0 0 0 
-154 131 0 0 166 72 0 0 0 0 0 0 0 0 0 0 
23 0 0 0 -39 0 0 0 0 0 0 0 0 0 0 0 
-154 131 166 72 0 0 0 0 0 0 0 0 0 0 0 0 
23 0 -39 0 0 0 0 0 0 0 0 0 0 0 0 0 
90 -5 0 0 0 0 0 0 0 0 0 0 0 0 0 0 
-130 0 0 0 0 0 0 0 0 0 0 0 0 0 0 0 

