120 93 183 417
0 101 24 -209 24 -209 65 -95 -119 -360 -63 -120 -63 -120 -27 8 
-101 0 -182 0 -182 0 -39 0 -15 0 -57 0 -57 0 -39 0 
-24 182 0 0 0 0 0 0 26 -370 0 0 98 -140 0 0 
209 0 0 0 0 0 0 0 24 0 0 0 -146 0 0 0 
-24 182 0 0 0 0 0 0 26 -370 98 -140 0 0 0 0 
209 0 0 0 0 0 0 0 24 0 -146 0 0 0 0 0 
-65 39 0 0 0 0 0 0 102 -190 0 0 0 0 0 0 
95 0 0 0 0 0 0 0 -228 0 0 0 0 0 0 0 
119 15 -26 -24 -26 -24 -102 228 0 0 0 0 0 0 0 0 
360 0 370 0 370 0 190 0 0 0 0 0 0 0 0 0 
63 57 0 0 -98 146 0 0 0 0 0 0 0 0 0 0 
120 0 0 0 140 0 0 0 0 0 0 0 0 0 0 0 
63 57 -98 146 0 0 0 0 0 0 0 0 0 0 0 0 
120 0 140 0 0 0 0 0 0 0 0 0 0 0 0 0 
27 39 0 0 0 0 0 0 0 0 0 0 0 0 0 0 
-8 0 0 0 0 0 0 0 0 0 0 0 0 0 0 0 
0 0 0 0 0 0 0 0 0 0 0 0 0 0 0 0
0 0 0 0 0 0 0 0 0 0 0 0 0 0 0 0
0 0 0 0 0 0 0 0 0 0 0 0 0 0 0 0
0 0 0 0 0 0 0 0 0 0 0 0 0 0 0 0
0 0 0 0 0 0 0 0 0 0 0 0 0 0 0 0
0 0 0 0 0 0 0 0 0 0 0 0 0 0 0 0
0 0 0 0 0 0 0 0 0 0 0 0 0 0 0 0
0 0 0 0 0 0 0 0 0 0 0 0 0 0 0 0
0 0 0 0 0 0 0 0 0 0 0 0 0 0 0 0
0 0 0 0 0 0 0 0 0 0 0 0 0 0 0 0
0 0 0 0 0 0 0 0 0 0 0 0 0 0 0 0
0 0 0 0 0 0 0 0 0 0 0 0 0 0 0 0
0 0 0 0 0 0 0 0 0 0 0 0 0 0 0 0
0 0 0 0 0 0 0 0 0 0 0 0 0 0 0 0
0 0 0 0 0 0 0 0 0 0 0 0 0 0 0 0
0 0 0 0 0 0 0 0 0 0 0 0 0 0 0 0
